15 15

^	^	Z	@	@	@	@	+	+	+	+	+	Z	#	#
^	^	+	+	@	@	@	+	^	^	^	+	~	~	#
^	^	^	+	@	@	@	+	^	^	^	+	~	~	~
^	^	^	+	~	~	~	+	^	^	^	+	~	~	~
~	~	~	+	~	~	~	+	^	^	+	+	+	+	~
#	~	~	+	~	~	~	+	+	+	+	@	@	+	~
#	~	~	+	~	~	+	+	S	@	@	@	@	+	@
~	~	~	+	+	+	+	S	S	@	@	@	@	+	@
@	+	+	+	@	@	S	S	S	@	@	@	@	+	@
@	+	@	@	@	@	+	+	+	+	+	+	+	+	@
@	+	@	@	@	@	+	@	@	@	+	~	~	~	~
@	+	+	+	+	+	+	@	@	@	+	@	@	@	@
@	+	^	^	^	^	+	@	@	@	+	@	@	@	@
@	+	+	+	+	+	+	+	+	@	+	^	^	@	@
@	@	@	@	~	~	~	~	X	+	+	^	^	#	#